7,1,1,1,1,1,1,1,1,6
4,19,10,10,10,10,10,10,18,4
4,12,16,11,11,11,11,17,13,4
4,12,13,,,,,12,13,4
4,12,13,,,,,12,13,4
4,12,13,,27,28,,12,13,4
4,12,13,,,,,12,13,4
4,12,13,,,,,12,13,4
4,12,14,10,10,10,10,15,13,4
4,21,11,11,11,11,11,11,20,4
9,1,1,1,1,1,1,1,1,8
