7,1,1,1,1,32,1,1,1,1,32,1,1,1,1,1,1,1,6
4,,25,25,,5,,,,,4,,,,,,,,4
4,,,,,,,22,23,,4,,22,23,,22,23,,4
4,,22,23,,,,,,,4,,,,,,,,4
4,,,,,3,24,,,24,4,,22,23,,22,23,,4
29,1,1,1,1,33,2,,,0,30,,,,,,,,4
4,,26,26,,5,24,,,24,4,,22,23,,22,23,,4
4,,,,,,,,,,5,,,,,,,,4
4,,,,,3,24,,,,,,22,23,,22,23,,4
29,1,1,1,1,30,,,,,,,,,,,,,4
4,,,,,5,24,,,,,,22,23,,22,23,,4
4,,22,23,,,,,,,3,,,,,,,,4
4,,,,,,,,,,4,,22,23,,22,23,,4
4,,,,,3,24,,,24,4,,,,,,,,4
9,1,1,1,1,31,1,1,1,1,31,1,1,1,1,1,1,1,8
