,,,34,36,36,36,36,36,35,36,36,36,36,36,37,,,
7,1,1,38,40,40,40,40,40,39,40,40,40,40,40,41,1,1,6
4,,,,42,27,28,42,,,,42,27,28,42,,,,4
4,,,,,,,,,,,,,,,,,,4
29,1,2,,3,,,0,1,1,1,2,,,3,,0,1,30
4,,,,4,,,,,,,,,,4,,,,4
4,43,,43,29,1,1,1,2,,0,1,1,1,30,43,,43,4
4,,,,4,,,,,,,,,,4,,,,4
4,,,,4,,,27,28,,27,28,,,4,,,,4
4,43,,43,4,,,,,,,,,,4,43,,43,4
4,,,,29,1,1,1,2,,0,1,1,1,30,,,,4
4,,,,4,,,,,,,,,,4,,,,4
4,43,,43,5,,,,42,,42,,,,5,43,,43,4
4,,,,,,,,,,,,,,,,,,4
9,1,1,1,1,1,1,1,1,1,1,1,1,1,1,1,1,1,8
